          *********
          *********
          *********
          *********
          *********
          *********          
             ***
             ***
             ***
*******      ***      *******
*******    *******    *******
*****************************
*****************************
*****************************
*******    *******    *******
*******      ***      *******
             ***
             ***
             ***     
          *********
          *********
          *********
          *********
          *********
          *********